#######
# a   #
#   P #
#     #
#  A  #
#######