######
#  b #
#a   #
#   B#
#  P #
######