########
#  b   #
#     C#
#      #
# P    #
#   a  #
#      #
########