########
#      #
#    E #
#      #
#aaaaaa#
#      #
#      #
# P  A #
#      #
########