########
#      #
#      #
#  ##  #
#  ##  #
#  ##P #
#a ## A#
########