########
#      #
# AA   #
#      #
#      #
#      #
#      #
#   aa #
#P     #
########