########
#  P  ##
#  # A #
#      #
# #    #
# a  # #
#  #   #
########