########
#     P#
#      #
#A   ###
#    ###
#     a#
#      #
########