########
#  P   #
#      #
#    A #
#      #
# a    #
#      #
########