########
#  B   #
#b   # #
##   A #
#  #   #
# P #  #
#   a  #
########