########
#a     #
#####  #
#####  #
##### P#
#####  #
#####A #
########