########
### A###
###  ###
###P ###
###  ###
###  ###
### a###
########