########
#  P  c#
#b     #
#    A #
#C     #
# a    #
#   B  #
########