########
#a     #
#      #
#  ##  #
#  ##  #
#    P #
#     A#
########