########
#  B   #
#      #
#    P #
# d    #
#      #
#   B  #
########