########
#  P   #
# b    #
#    B #
#      #
# a    #
#   C  #
########