########
#  P   #
#c     #
#    D #
#      #
# a    #
#      #
########